1111111111111
100100000E0C1
10C0011111001
1P0011E00C001
1111111111111
