1111111111111111111111111111111111
1E10C0100000000C00000C00001C100E01
1010101010011000010110110110101011
1010101010011001000110110110101011
1P00100010C00C00000000000000000001
1111111111111111111111111111111111
