1111111111111111111111
1C1000111100111C001111
1010101111001111101E11
1000000P00000000001111
1011101011011010111011
1111111011001010001011
100011101C011010111011
1010101011111110101011
1110111010001010111011
1000C00C101010000000E1
1111111111111111111111
